Fonetiks:

    thom - tom 
    coope - cöpe 
    co-op - cöp 
    alk - ak
    sh - ʃ 
    tio - ʃo
    sio - ʃo 
    sure - ʃur
    wh - w 
    co - ko
    cu - ku
    ca - ka
    ck - k
    ic - ik
    cr - kr
    ci - si
    ce - se
    cy - sy
    ch - c
    ikh - ic
    kn - gn
    ec - ek
    act - akt
    cem - kem
    whik - whic
    nge - nje
    ng - ŋ
    nk - ŋk
    ph - f
    ause - auz
    ouse - aus
    cough - koff
    laugh - laff
    enough - enuf
    tough - tuff
    ough - o
    gh - "" 
    exa - egza
    exi - egzi
    ax - aks
    ox - oks
    ux - uks
    ix - iks
    ex - eks
    x - z
    oo - u
    þro - þru
    þruw - þrow
    of - ov
    uld - ud
    kss - ks
    idk - idg
    ture - cur
    æcʃ - ækʃ
    wið - wiþ
    arsitekkur - arkitekcur
    geo - jeo
    rge - rje
    th - ð
    th - þ




Runetiks:

   Th - ᚦ
   Ai - ᛇ
   Ae - ᚫ
   Ea - ᛠ
   Oe - ᛟ
   Ng - ᛝ

    A - ᚪ
    B - ᛒ
   Ch - ᚳ
    D - ᛞ
    E - ᛖ
    F - ᚠ
    G - ᚷ
    H - ᚻ
    I - ᛁ
    J - ᛡ
    K - ᛣ
    L - ᛚ
    M - ᛗ
    N - ᚾ
    O - ᚩ
    P - ᛈ
    Q - ᛢ
    R - ᚱ
    S - ᛋ
    T - ᛏ
    U - ᚢ
    V - ᛒᛥ
    W - ᚹ
    X - ᛉ
    Y - ᚣ
    Z - ᛋᛥ

    " " - •
